71.ox
...o...o...
...........
....ooo.o..
oo.........
...o.......
.........o.
.....oo...o
.o.o.o..o..
......ooo..
o........o.
...o...o...
..o........
oo..o...o.o
....oo...o.
.......o...
...o......o
........o.o
...o..o....
.....oo....
........oo.
.oo...oo...
......o....
.....o..o..
.....oo....
....o.....o
...........
.o...o.....
o.oo......o
...........
oo..o......
o.....o...o
..o..o.....
.o..o.....o
....o...o..
....o.o....
o....o.....
.o.....oo..
...........
..o...oo...
...o.....oo
..o........
......o.oo.
..o.....o.o
.o.o.oo....
........o..
o.o....o...
o.....o....
...........
....o...o..
o..o..o....
.........o.
.o......o..
....o...o..
...........
o..o....o.o
ooo.......o
......o....
o..o.......
..o........
....o...o..
o.o.o....o.
......ooo..
....o......
.o.o..o....
.......oooo
...oo.o..o.
.o.....oooo
.....o.....
...o.......
.......o...
.o....o..oo
